{
  "A1": "11111111-R1-glu",
  "A2": "33333333-R1-glu",
  "A3": "55555555-R1-glu",
  "C1": "11111111-R2-glu",
  "C2": "33333333-R2-glu",
  "C3": "55555555-R2-glu",
  "E1": "11111111-R3-glu",
  "E2": "33333333-R3-glu",
  "E3": "55555555-R3-glu",
  "G1": "N-glu-R1",
  "G2": "N-glu-R2",
  "G3": "N-glu-R3",
  "A4": "11111111-R1-xyl",
  "A5": "33333333-R1-xyl",
  "A6": "55555555-R1-xyl",
  "C4": "11111111-R2-xyl",
  "C5": "33333333-R2-xyl",
  "C6": "55555555-R2-xyl",
  "E4": "11111111-R3-xyl",
  "E5": "33333333-R3-xyl",
  "E6": "55555555-R3-xyl",
  "G4": "N-xyl-R1",
  "G5": "N-xyl-R2",
  "G6": "N-xyl-R3",
  "A7": "11111111-R1-man",
  "A8": "33333333-R1-man",
  "A9": "55555555-R1-man",
  "C7": "11111111-R2-man",
  "C8": "33333333-R2-man",
  "C9": "55555555-R2-man",
  "E7": "11111111-R3-man",
  "E8": "33333333-R3-man",
  "E9": "55555555-R3-man",
  "G7": "N-man-R1",
  "G8": "N-man-R2",
  "G9": "N-man-R3"
}