{
  "A1": "12345654-R1-glu",
  "A2": "66666666-R1-glu",
  "A3": "44444444-R1-glu",
  "B1": "12345654-R2-glu",
  "B2": "66666666-R2-glu",
  "B3": "44444444-R2-glu",
  "C1": "12345654-R3-glu",
  "C2": "66666666-R3-glu",
  "C3": "44444444-R3-glu",
  "A4": "12345654-R1-xyl",
  "A5": "66666666-R1-xyl",
  "A6": "44444444-R1-xyl",
  "B4": "12345654-R2-xyl",
  "B5": "66666666-R2-xyl",
  "B6": "44444444-R2-xyl",
  "C4": "12345654-R3-xyl",
  "C5": "66666666-R3-xyl",
  "C6": "44444444-R3-xyl",
  "A7": "12345654-R1-man",
  "A8": "66666666-R1-man",
  "A9": "44444444-R1-man",
  "B7": "12345654-R2-man",
  "B8": "66666666-R2-man",
  "B9": "44444444-R2-man",
  "C7": "12345654-R3-man",
  "C8": "66666666-R3-man",
  "C9": "44444444-R3-man"
}